param1;minDistance;#Validated (from true);#Rejected (from true);#Validated (from false);#Rejected (from false);ErrorValue;param2;minRadius
52;6;2179;42;11;2210;53;27;8
53;6;2179;42;11;2210;53;27;8
54;6;2178;43;10;2211;53;27;8
55;6;2178;43;10;2211;53;27;8
56;6;2178;43;10;2211;53;27;8
57;6;2178;43;10;2211;53;27;8
50;6;2179;42;12;2209;54;27;8
51;6;2179;42;12;2209;54;27;8
58;6;2177;44;10;2211;54;27;8
59;6;2177;44;10;2211;54;27;8
48;6;2179;42;13;2208;55;27;8
49;6;2179;42;13;2208;55;27;8
62;6;2175;46;9;2212;55;27;8
63;6;2175;46;9;2212;55;27;8
68;6;2175;46;9;2212;55;27;8
69;6;2175;46;9;2212;55;27;8
60;6;2175;46;10;2211;56;27;8
61;6;2175;46;10;2211;56;27;8
64;6;2174;47;9;2212;56;27;8
65;6;2174;47;9;2212;56;27;8
66;6;2174;47;9;2212;56;27;8
67;6;2174;47;9;2212;56;27;8
46;6;2178;43;14;2207;57;27;8
47;6;2178;43;14;2207;57;27;8
70;6;2173;48;9;2212;57;27;8
71;6;2173;48;9;2212;57;27;8
40;6;2179;42;16;2205;58;27;8
41;6;2179;42;16;2205;58;27;8
42;6;2179;42;16;2205;58;27;8
43;6;2179;42;16;2205;58;27;8
44;6;2178;43;15;2206;58;27;8
45;6;2178;43;15;2206;58;27;8
72;6;2172;49;10;2211;59;27;8
73;6;2172;49;10;2211;59;27;8
74;6;2172;49;10;2211;59;27;8
75;6;2172;49;10;2211;59;27;8
76;6;2170;51;10;2211;61;27;8
77;6;2170;51;10;2211;61;27;8
78;6;2170;51;10;2211;61;27;8
79;6;2170;51;10;2211;61;27;8
38;6;2179;42;20;2201;62;27;8
39;6;2179;42;20;2201;62;27;8
80;6;2169;52;10;2211;62;27;8
81;6;2169;52;10;2211;62;27;8
82;6;2169;52;10;2211;62;27;8
83;6;2169;52;10;2211;62;27;8
84;6;2169;52;10;2211;62;27;8
85;6;2169;52;10;2211;62;27;8
36;6;2179;42;21;2200;63;27;8
37;6;2179;42;21;2200;63;27;8
32;6;2179;42;22;2199;64;27;8
33;6;2179;42;22;2199;64;27;8
34;6;2180;41;23;2198;64;27;8
35;6;2180;41;23;2198;64;27;8
86;6;2167;54;10;2211;64;27;8
87;6;2167;54;10;2211;64;27;8
88;6;2167;54;10;2211;64;27;8
89;6;2167;54;10;2211;64;27;8
90;6;2167;54;10;2211;64;27;8
91;6;2167;54;10;2211;64;27;8
92;6;2167;54;10;2211;64;27;8
93;6;2167;54;10;2211;64;27;8
94;6;2166;55;10;2211;65;27;8
95;6;2166;55;10;2211;65;27;8
96;6;2166;55;10;2211;65;27;8
97;6;2166;55;10;2211;65;27;8
98;6;2166;55;10;2211;65;27;8
99;6;2166;55;10;2211;65;27;8
100;6;2166;55;10;2211;65;27;8
101;6;2166;55;10;2211;65;27;8
26;6;2180;41;25;2196;66;27;8
27;6;2180;41;25;2196;66;27;8
28;6;2180;41;25;2196;66;27;8
29;6;2180;41;25;2196;66;27;8
30;6;2179;42;24;2197;66;27;8
31;6;2179;42;24;2197;66;27;8
102;6;2165;56;10;2211;66;27;8
103;6;2165;56;10;2211;66;27;8
104;6;2165;56;10;2211;66;27;8
105;6;2165;56;10;2211;66;27;8
106;6;2165;56;10;2211;66;27;8
107;6;2165;56;10;2211;66;27;8
108;6;2165;56;10;2211;66;27;8
109;6;2165;56;10;2211;66;27;8
110;6;2165;56;10;2211;66;27;8
111;6;2165;56;10;2211;66;27;8
130;6;2164;57;9;2212;66;27;8
131;6;2164;57;9;2212;66;27;8
132;6;2164;57;9;2212;66;27;8
133;6;2164;57;9;2212;66;27;8
134;6;2164;57;9;2212;66;27;8
135;6;2164;57;9;2212;66;27;8
136;6;2164;57;9;2212;66;27;8
137;6;2164;57;9;2212;66;27;8
138;6;2164;57;9;2212;66;27;8
139;6;2164;57;9;2212;66;27;8
24;6;2180;41;26;2195;67;27;8
25;6;2180;41;26;2195;67;27;8
112;6;2164;57;10;2211;67;27;8
113;6;2164;57;10;2211;67;27;8
114;6;2164;57;10;2211;67;27;8
115;6;2164;57;10;2211;67;27;8
116;6;2164;57;10;2211;67;27;8
117;6;2164;57;10;2211;67;27;8
118;6;2164;57;10;2211;67;27;8
119;6;2164;57;10;2211;67;27;8
120;6;2164;57;10;2211;67;27;8
121;6;2164;57;10;2211;67;27;8
122;6;2163;58;9;2212;67;27;8
123;6;2163;58;9;2212;67;27;8
124;6;2163;58;9;2212;67;27;8
125;6;2163;58;9;2212;67;27;8
126;6;2163;58;9;2212;67;27;8
127;6;2163;58;9;2212;67;27;8
128;6;2163;58;9;2212;67;27;8
129;6;2163;58;9;2212;67;27;8
140;6;2162;59;9;2212;68;27;8
141;6;2162;59;9;2212;68;27;8
142;6;2162;59;9;2212;68;27;8
143;6;2162;59;9;2212;68;27;8
144;6;2162;59;9;2212;68;27;8
145;6;2162;59;9;2212;68;27;8
146;6;2162;59;9;2212;68;27;8
147;6;2162;59;9;2212;68;27;8
164;6;2163;58;10;2211;68;27;8
165;6;2163;58;10;2211;68;27;8
166;6;2163;58;10;2211;68;27;8
167;6;2163;58;10;2211;68;27;8
168;6;2163;58;10;2211;68;27;8
169;6;2163;58;10;2211;68;27;8
170;6;2163;58;10;2211;68;27;8
171;6;2163;58;10;2211;68;27;8
172;6;2163;58;10;2211;68;27;8
173;6;2163;58;10;2211;68;27;8
174;6;2163;58;10;2211;68;27;8
175;6;2163;58;10;2211;68;27;8
148;6;2162;59;10;2211;69;27;8
149;6;2162;59;10;2211;69;27;8
150;6;2162;59;10;2211;69;27;8
151;6;2162;59;10;2211;69;27;8
152;6;2162;59;10;2211;69;27;8
153;6;2162;59;10;2211;69;27;8
154;6;2162;59;10;2211;69;27;8
155;6;2162;59;10;2211;69;27;8
156;6;2162;59;10;2211;69;27;8
157;6;2162;59;10;2211;69;27;8
158;6;2162;59;10;2211;69;27;8
159;6;2162;59;10;2211;69;27;8
160;6;2162;59;10;2211;69;27;8
161;6;2162;59;10;2211;69;27;8
162;6;2162;59;10;2211;69;27;8
163;6;2162;59;10;2211;69;27;8
176;6;2162;59;10;2211;69;27;8
177;6;2162;59;10;2211;69;27;8
6;6;2183;38;32;2189;70;27;8
7;6;2183;38;32;2189;70;27;8
10;6;2182;39;31;2190;70;27;8
11;6;2182;39;31;2190;70;27;8
12;6;2182;39;31;2190;70;27;8
13;6;2182;39;31;2190;70;27;8
14;6;2182;39;31;2190;70;27;8
15;6;2182;39;31;2190;70;27;8
180;6;2159;62;8;2213;70;27;8
181;6;2159;62;8;2213;70;27;8
1;6;2183;38;33;2188;71;27;8
2;6;2183;38;33;2188;71;27;8
3;6;2183;38;33;2188;71;27;8
4;6;2183;38;33;2188;71;27;8
5;6;2183;38;33;2188;71;27;8
8;6;2182;39;32;2189;71;27;8
9;6;2182;39;32;2189;71;27;8
20;6;2179;42;29;2192;71;27;8
21;6;2179;42;29;2192;71;27;8
22;6;2179;42;29;2192;71;27;8
23;6;2179;42;29;2192;71;27;8
178;6;2160;61;10;2211;71;27;8
179;6;2160;61;10;2211;71;27;8
182;6;2158;63;8;2213;71;27;8
183;6;2158;63;8;2213;71;27;8
18;6;2179;42;31;2190;73;27;8
19;6;2179;42;31;2190;73;27;8
16;6;2180;41;34;2187;75;27;8
17;6;2180;41;34;2187;75;27;8
184;6;2153;68;9;2212;77;27;8
185;6;2153;68;9;2212;77;27;8
186;6;2147;74;9;2212;83;27;8
187;6;2147;74;9;2212;83;27;8
188;6;2141;80;9;2212;89;27;8
189;6;2141;80;9;2212;89;27;8
190;6;2137;84;9;2212;93;27;8
191;6;2137;84;9;2212;93;27;8
192;6;2129;92;9;2212;101;27;8
193;6;2129;92;9;2212;101;27;8
194;6;2128;93;9;2212;102;27;8
195;6;2128;93;9;2212;102;27;8
196;6;2124;97;9;2212;106;27;8
197;6;2124;97;9;2212;106;27;8
198;6;2118;103;9;2212;112;27;8
199;6;2118;103;9;2212;112;27;8
200;6;2112;109;9;2212;118;27;8
201;6;2112;109;9;2212;118;27;8
202;6;2102;119;9;2212;128;27;8
203;6;2102;119;9;2212;128;27;8
204;6;2096;125;9;2212;134;27;8
205;6;2096;125;9;2212;134;27;8
206;6;2089;132;8;2213;140;27;8
207;6;2089;132;8;2213;140;27;8
208;6;2083;138;8;2213;146;27;8
209;6;2083;138;8;2213;146;27;8
210;6;2074;147;8;2213;155;27;8
211;6;2074;147;8;2213;155;27;8
212;6;2060;161;8;2213;169;27;8
213;6;2060;161;8;2213;169;27;8
214;6;2044;177;8;2213;185;27;8
215;6;2044;177;8;2213;185;27;8
216;6;2031;190;8;2213;198;27;8
217;6;2031;190;8;2213;198;27;8
218;6;2010;211;8;2213;219;27;8
219;6;2010;211;8;2213;219;27;8
220;6;1986;235;9;2212;244;27;8
221;6;1986;235;9;2212;244;27;8
222;6;1959;262;9;2212;271;27;8
223;6;1959;262;9;2212;271;27;8
224;6;1929;292;9;2212;301;27;8
225;6;1929;292;9;2212;301;27;8
226;6;1901;320;9;2212;329;27;8
227;6;1901;320;9;2212;329;27;8
228;6;1868;353;9;2212;362;27;8
229;6;1868;353;9;2212;362;27;8
230;6;1841;380;9;2212;389;27;8
231;6;1841;380;9;2212;389;27;8
232;6;1798;423;8;2213;431;27;8
233;6;1798;423;8;2213;431;27;8
234;6;1764;457;8;2213;465;27;8
235;6;1764;457;8;2213;465;27;8
236;6;1728;493;8;2213;501;27;8
237;6;1728;493;8;2213;501;27;8
238;6;1705;516;8;2213;524;27;8
239;6;1705;516;8;2213;524;27;8
240;6;1666;555;8;2213;563;27;8
241;6;1666;555;8;2213;563;27;8
242;6;1642;579;8;2213;587;27;8
243;6;1642;579;8;2213;587;27;8
244;6;1618;603;8;2213;611;27;8
245;6;1618;603;8;2213;611;27;8
246;6;1597;624;8;2213;632;27;8
247;6;1597;624;8;2213;632;27;8
248;6;1578;643;6;2215;649;27;8
249;6;1578;643;6;2215;649;27;8
250;6;1562;659;6;2215;665;27;8
251;6;1562;659;6;2215;665;27;8
252;6;1521;700;6;2215;706;27;8
253;6;1521;700;6;2215;706;27;8
254;6;1489;732;6;2215;738;27;8
255;6;1489;732;6;2215;738;27;8
256;6;1445;776;6;2215;782;27;8
257;6;1445;776;6;2215;782;27;8
258;6;1408;813;6;2215;819;27;8
259;6;1408;813;6;2215;819;27;8
260;6;1361;860;7;2214;867;27;8
261;6;1361;860;7;2214;867;27;8
262;6;1324;897;7;2214;904;27;8
263;6;1324;897;7;2214;904;27;8
264;6;1275;946;6;2215;952;27;8
265;6;1275;946;6;2215;952;27;8
266;6;1233;988;6;2215;994;27;8
267;6;1233;988;6;2215;994;27;8
268;6;1194;1027;6;2215;1033;27;8
269;6;1194;1027;6;2215;1033;27;8
270;6;1156;1065;6;2215;1071;27;8
271;6;1156;1065;6;2215;1071;27;8
272;6;1127;1094;6;2215;1100;27;8
273;6;1127;1094;6;2215;1100;27;8
274;6;1099;1122;6;2215;1128;27;8
275;6;1099;1122;6;2215;1128;27;8
276;6;1072;1149;6;2215;1155;27;8
277;6;1072;1149;6;2215;1155;27;8
278;6;1051;1170;7;2214;1177;27;8
279;6;1051;1170;7;2214;1177;27;8
280;6;1028;1193;7;2214;1200;27;8
281;6;1028;1193;7;2214;1200;27;8
282;6;1009;1212;7;2214;1219;27;8
283;6;1009;1212;7;2214;1219;27;8
284;6;986;1235;8;2213;1243;27;8
285;6;986;1235;8;2213;1243;27;8
286;6;973;1248;8;2213;1256;27;8
287;6;973;1248;8;2213;1256;27;8
288;6;954;1267;6;2215;1273;27;8
289;6;954;1267;6;2215;1273;27;8
290;6;937;1284;6;2215;1290;27;8
291;6;937;1284;6;2215;1290;27;8
292;6;916;1305;5;2216;1310;27;8
293;6;916;1305;5;2216;1310;27;8
294;6;900;1321;5;2216;1326;27;8
295;6;900;1321;5;2216;1326;27;8
296;6;880;1341;4;2217;1345;27;8
297;6;880;1341;4;2217;1345;27;8
298;6;866;1355;4;2217;1359;27;8
299;6;866;1355;4;2217;1359;27;8
300;6;857;1364;4;2217;1368;27;8
301;6;857;1364;4;2217;1368;27;8
302;6;843;1378;4;2217;1382;27;8
303;6;843;1378;4;2217;1382;27;8
304;6;832;1389;4;2217;1393;27;8
305;6;832;1389;4;2217;1393;27;8
306;6;817;1404;4;2217;1408;27;8
307;6;817;1404;4;2217;1408;27;8
308;6;800;1421;3;2218;1424;27;8
309;6;800;1421;3;2218;1424;27;8
